11111111111
1000100E011
10010000001
10100000001
11001010001
10010P01001
10001010001
100C0100011
11111111111
