1111111111111111111111
100001C0000000011110C1
1000010000000001111001
10C0010000000001111001
1000P00000000001111001
1000C00000000001111001
1000000000000001111001
10000000000C0001111001
1111111111111001111001
100001C000000001000001
1000010000000C01000001
10C00100000000010000C1
100000000E000000000001
1000C00000000001000001
1000000000000001000001
10000000000C0001000001
1111111111111111111111
