111111111111111111
10EP000000100C0001
111111110000011111
100000000000000C01
111111111111111111
