1111111111111111111111111111111111
10000000000000000000000010000010E1
1000000000000C000000C0001000C01C01
1000000000000C000000C0001000C01C01
1000000000000C000000C0001000C01C01
1000000000000C000000C0001000C01C01
1000000000000C000000C0001000C01C01
1000000000000C000000C0001000C01C01
1P00000000000000000000000000000001
1111111111111111111111111111111111
